11111111111111111111111111111111111111111111111111111111111111111111111111111111111111111111111111111111111111111111111111111111111111111111111111
00000000000000000000000000000000000000000000000000000000000000000000000000000000000000000000000000000000000000000000000000000000000000000000000001
01111111111111111111111111000000000000000000000000000000000000000000000000000000000000000000111111000000000000000000111111111111111111111111111101
01111111111111111111111111000000000000000000000000000000000000000000000000000000000000000110111111000000000000000000111111100111111111111111111101
01111111111111111111111111000011111111111111111011111111110011111011111011111011110011110000111111000000000000000000111101100111111111111111111101
01111111111111111111111111110011111111111111111011111111110011111011111011111011110011110011111111111001100000001001111000100111111111111111111101
01111111111111111111111111110011111111111111111011111111110011111011111011111011110011110000001111111001100000001001110010100111111111111111111101
01111111111111111111111111110011111111111111111011111111110011111011111011111011110011110000001110000001100000001001110000000111111111111111111101
01111111111111111111111111110011111111111111111011111111110011111011111011111011110011110011111111111001111100001001110000000111111111111111111101
01111111111111111111111111110011111111111111111011111111110011111011111011111011110011110011111111111001111100001001110000000110001111111111111101
01111111111111111111111111110011111111111111111011111111110011111011111011111011110011110011111111111001111100001001110000000110000000000011111101
01111111111111111111111111110011111111111111111011111111110011111011111011111011110011110011111111111001111100001001110000000010000000000011111101
01111111111111111111111111110011111111111111111000000011110011111011111011111011110011110011111111111111111100001001110000000010000000000000111101
01111111111111111111111111110011111111111111111011110011110011111011111011111011110011110011111111111001100000001001110000000000000000000000111101
01111111111111111111111111110011111111111111111011111111110011111011111011111011110011110011111111111001100001001001110000000000000000000111111101
01111111111111111111111111110011111111111111111011110011110011111011111011111011110011110011111111111001100000001001110000000000000000000111111101
01111111111111111111111111110010000000000010000000000001000000010001000000010001000000010000001110000001000000000001111100000000000000000111111101
01111111111111111111111111110010000000000010000000000001000000010001000000010001000000010000001110000001000000000001111111111111111111111111111101
01111111111111111111111111110011111111111111111111111111111111111111111111111111111111111111111111111111111111111001111111111111111111111111111101
01111111111111111111111111110011111111111111111111111111111111111111111111111111111111111111111111111111111111111001111111111111111111111111111101
01110000000000000000000000000000000000000000111111000000000000000000001100000000000001111111111111111111111111111011111111111111111111111111111101
01110000000000000000000000000000000000000000111111000000000000000000001100000000000000000000111111000000000000000000000000000000000000000011111101
01110011111111110111111111111111011111111101111111111111111111111000001100000000000000000000111111000000000000000000000000000000000000000011111101
01110011111111111111111111111111111111111111111111111111111111111111111111111111011111111111111111001111111111111011111111001111111111111011111101
01110011111111110111111111111111011111111101111111111111111111111111111111111111111111111111111111111111111111111111111111001111111111111011111101
01110011111111110111111111111111011111111100011111111111111111111111111111111111111111111111111110001111111111111011111111001111111111111011111101
01110011111111110111111111111111011111111101111111111111111111111111111111111111111111111111111111001111111111111011111111001111111111111011111101
01110011111111110111111111111111011111111101111111111111111111111111111111111111111111111111111111001111111111111011111111001111111111111011111101
01110011111111110111111111111111011111111101111111111111111111111111111111111111111111111111111111001111111111111011111111001111111111111011111101
01110000000000100000000000000000000001000000011100100000000000000000000000000000000000000000011111001111111111111011111111001111111111111011111101
01110000000000100000000000000000000001000000011100100000000000000000000000000000000000000000011100000011111111110001000001001111111111111011111101
01110011111111111111111111111101111111111110011100111111111101111111111111111111111111111110011100111111111111111111100011111111111111111011111101
01110011111111111111111111111111111111111110011100111111111101111111111111111111111111111110011100111111111111111111101111111111111111111011111101
01110011111111111111111111111101111111111110011100111111111101111111111111111111111111111110011100111111111111111111101111111111111111111011111101
01110011111111111111111111111101111111111110011100111111111101111111111111111111111111111110011111111111111111111111101111111111111111111011111101
01110011111111111111111111111101111111111110011100111111111101111111111111111111111111111110011100111111111111111111101111111111111000000011111101
01110011111111111111111111111101111111111110011100111111111101111111111111111111111111111110011100000000000000000000001111111111111000000011111101
01110011111111111111111111111101111111111110011100111111111101111111111111111111111111111110011100000000000000000000001111111111111011111111111101
01110011111111111111111111111101111111111110011100111111111101111111111111111111111111111110011100000000010000111111111111111111111011111011111101
01110011111111111111111111111101111111111110011100111111111101111111111111111111111111111110011111111001000000111111111111111111111011111011111101
01110011111111111111111111111101111111111110011100111111111101111111111111111111111111000000011111111100000011111111111111111111111011111011111101
01110011111111111111111111111101111111111111111111111111111101111111111111111111111111011110011111111000010000111111111111111111111111111011111101
01110011111111111111111111111101111111111110011100000000000001111111111111111111111111111111111100000000000000111111111111111111111111111011111101
01110011111111111111111111111101111111111110011100000000000001111111111111111111111111011110011100000000000000111111001111111111111111111011111101
01110011111111111111111111111101111111111110011100111111111101111111111111111111111111011110011100111111111111111111001111111111111011111011111101
01110011111111111111111111111101111111111110011100111111111100000000000000000000000000011110011100111111111001111111001111111111111000000011111101
01110011111111111111111111111101111111111110011100111111111100000000000000000000000000011110011100111111111001111111001111111111111000000011111101
01110011111111111111111111111101111111111110011100111111111111111111111111111111111111111110011100111111111001111111001111111111111011111011111101
01110000000000011000000000100000000000000100011100000000000000000000000000000000000000000000011100111111111001111111001111111111111011111011111101
01110000000000011000000000100000000000000100011100000000000000000000000000000000000000000000011100000000000000000000000000000000111011110011111101
01110011111110011001111111111111111001111110011111100111111110011111110111111111111111111111111111111111100111111111111111111110111111110011111101
01110011111110010001111111111111111001111110011100100111111110011111110111111111111111111111111100111111100111111111111111111110111011110011111101
01110011111110011001111111111111111001111110011100100000111110011111100111111111111111111111111100111111100111111111111111111110001011110011111101
01110011111110011001111111111111111001111110011100100111100000000000100111111111111111111110011100111111100111111111111111111110011011110011111101
01110011111110011001111111111111111111111110011100100111100000000000110111111111111111111110011100111111100111111111111111111110111011110011111101
01110011111111111001111111111111111001111110011100100111111101111111110111111111111111111110011100111111100111111111111111111110111011110011111001
01110000000000011000000000000000000000000000011100000001000000100000000000000000000000000000011100000000000000000000000000000000000001000011111001
01110000000000011000000000000000000000000000011100000001000000100000000000000000000000000000011100000000000000000000000000000000000000000011111001
01110000010000011100000000000000000000000000011100000001000000100000000000000000000000000000011100000000000000000000000000000000000000000011111001
01110011111111111111111100000000001111110111111111111111111111111111111111111111111111111111111111111111100000000000000011111111111111110011111001
01110011111110011111111100000000001111110111111111111111111111111111111111111111111111111111111111100110000000000000000001111111111111110011111001
01110011111110011111111100000000001111110111111111111111111111111111111111111111111111111111111111100111100000000000000001111111111111110011111001
01110011111110011111111100000000001111110111111111111111111111111111111111111111111111111111111111100111100000000000000001111111111111110011111001
01110011111110011111111111111111111111110111111111111111111111111111111111111111111111111111111111100111111110000000000001111111111111111111111001
01110011111110011111111111111111111111100000000000000000000111111111111111111111111111111111111111100111111000000000000001111111111111111111111001
01110011111110011111111111111111111111100000000000000000000000000000011100000000000000000000000000000011111000000000000011111111111111111111111001
01110000000000011000000000001100000000000010000000000000000000000000011100000000000000000000000000000011111110000000000011111111111111110011111001
01110000000000010001111111100000000000000111111111111111111111111001111111100111111111111111111111110011100000000000000000000000010000000011111001
01110000000000010001111111100110111111100111111111111111111111111001111111100111111111111111111111110011100000000000000000000000010000000011111001
01110011111110011001111111101110111111100111111111111111111111111000011111100111111111111111111111110011111111111111111111111111111001110011111001
01110011111110011001111111101110111111100111111111111111111111111000011100000111111111111111111111110011111111111111111111111111111111110011111001
01110011111110011001111111101110111111100111111111111111111111111010011110110111111111111111111111110011111111111111111111111111111001110011111001
01110011111110011001111111101110111111100111111111111111111111111000111110000111111111111111111111110011111111111111111111111111111001110011111001
01110011111110011001111111101110111111100111111111111111111111111001111111100111111111111111111111110011111111111111111111111111110000110011111001
01110011111111111111111111101111111111100111111111111111111111111001111111100111111111111111111111110011111111111111111111111111100110010011111001
01110000000000011001111111101110000000000111111111111111111111111000000000000111111111111111111111110011111111111111111111111111101110000011111001
01110000000000011001111111101110000000000111111111111111111111111000000000000111111111111111111111110011111111111111111111111111001111000011111001
01110011111111111001111111101111111111100111111111111111111111111000000000000111111111111111111111110011111111111111111111111111001111000011111001
01110011111110011001111111101110111111100111111111111111111111111000000000000111111111111111111111110011111111111111111111111111001111000011111001
01110011111110011000000000001110111111100111111111111111111111111000000000000111111111111111111111110011111111111111111111111111001111000011111001
01110011111110011000000000001110111111100111111111111111111110000000000000000000111111111111111111110011111111111111111111111111001111000011111001
01110011111110011001111111101110111111100111111111111111111110000001111111100000111111111111111111110011111111111111111111111111001111000011111011
01110011111110011001111111101110111111100111111111111111111110011111111111111100111111111111111111110011111111111111111111111111001111000011111011
01110011111110011001111111101110111111100111111111111111111110011111111111111100111111111111111111110011111111111111111111111111001111000011111011
01110000000000011001111111101110000000000111111111111111111110000000000000000000111111111111111111110011111111111111111111111111001111000011111011
01110011111110011000001000001110111111100111111111111111111110000000000000000000111111111111111111110011111111111111111111111111001111000011111011
01110011111110011111111111111110111111100111111111111111111110000000000000000000111111111111111111110011111111111111111111111111001111000011111011
01110011111111111111111111111110111111100111111111111111111110000000000000000000111111111111111111110011111111111111111111111111011111000011111011
01110011111110000000001000000000111111100111111111111111111110000000000000000000011111111111111111110011111111111111111111111111011111000011111011
01110000000000000000001000000000111111100111111111111111111110000000000000000000011111111111111111110011111111111111111111111111011111000011111011
01110011111110011111111111111110111111100111111111111111111110000000000000000000011111111111111111110011111111111111111111111111011111000011111011
01110011111110011111111111111110111111100111111111111111111100000000000000000000011111111111111111110011111111111111111111111111011111000011111011
01110011111110011111111111111110111111100111111111111111111111111111111111111111111111111111111111110011111111111111111111111111011111000011111011
01110011111110011111111111111110111111100111111111111111111111111111111111111111111111111111111111110011111111111111111111111111001111000011111011
01110011111110011111111111111110111111100111111111111111111111111111111111111111111111111111111111110011111111111111111111111111100110010011111011
01110011111110011111111111111110111111100111111111111111111111111111111111111111111111111111111111110011111111111111111111111111110000110011111011
01110011111111111111111111111111111111100111111111111111111111111111111111111111111111111111111111110011111111111111111111111111110000110011111011
01110011111100011111111111111110011111100111111111111111111111111111111111111111111111111111111111110011111111111111111111111111111001110011111011
01110011111101111111111111111111011111100111111111111111111111111111111111111111111111111111111111110011111111111111111111111111111001110011111011
01110011111101111111111111111111011111100111111111111111111111110011001000111111000111111111111111110011111111111111111111111111111111110011111011
01110011111101111111111111111111011111100111111111111111111111110000000000000000001111111111111111110011111111111111111111111111111001110011111011
01110000000000000000000000000000000000000111111111111111111111110000000000000000001111111111111111110000000000000000000000000000000000000011111011
01110000000000000000000000000000000000000111111111111111111111110000010000000000011111111111111111110000000000000000000000000000000000000011111011
01111111111111111111111111111111111111111111111111111111111111110000010000000000011111111111111111111111111111111111111111111111111111111111111011
01111111111111111111111111111111111111000000000000000000000000000000000000000000000000000000000000000000000000000000000000000000000000000000000011
01111111111111111111111111111111111111011111111111111111111100000000000000000011111111100000000000011111000010000000000000000000000001000111111011
01111111111111111111111111111111111111011111111111111111111100000000000000000111111111100111111000011111001100000000000000000001101000001111111011
01111111111111111111111111111111111111011111111111111111111100000000000000011111111111100000000000000000000000000000000000000000000000000000000011
01111111111111111111111111111111111111011111111111111111111100000010000000011111111111100000000000001111000000100000000000001100000000000000111011
00000000000000000000000000000000000000000000000000000000000000000000000000000000000000000000000000001111011111000000000000001101111110000000111011
00000000000000000000000000000000000000000000000000000000000000000000000000000000000000000000000000000000000000000000000000000000000000000000000011
11111111111111111111111111111111111111111111111111111111111111111111111111111111111111111111111111111111111111111111111111111111111111111111111111
